140.112.107.821
152.66.245.1611
204.123.28.561
204.8.155.2271
140.192.249.2041
128.252.19.181
128.223.8.1111
141.213.4.2021
72.36.112.711
169.229.50.151
129.237.161.1941
140.109.17.1801
202.116.81.1951
139.19.158.2311
220.245.140.1971
133.68.253.2431
128.223.8.1141
200.129.132.181
192.91.235.2301
202.116.81.1941
128.238.88.641
128.42.142.441
143.215.131.1991
137.132.80.1051
128.163.142.211
137.165.1.1131
165.91.55.81
129.242.19.1971
206.12.16.1551
208.77.77.1961
139.19.158.2291
202.249.37.691
192.33.90.691
192.16.125.121
169.229.50.121
128.111.52.581
128.220.251.521
82.179.176.441
149.43.80.201
128.233.252.111
139.19.142.51
131.247.2.2461
190.227.163.1411
195.113.161.831
133.15.59.11
128.208.3.1801
140.112.42.1581
128.84.154.411
165.230.49.1191
202.125.215.121
170.140.119.701
128.84.154.401
204.8.155.2261
202.23.159.511
193.63.75.211
129.32.84.1601
130.49.221.401
208.77.77.1951
193.226.19.301
137.132.80.1061
193.166.167.51
138.4.0.1201
192.91.235.2291
130.83.166.2451
163.117.253.221
198.133.224.1491
149.43.80.221
143.205.172.121
221.199.217.1451
193.0.109.251
163.117.253.231
139.19.158.2271
133.68.253.2421
160.193.163.1061
132.170.3.321
128.223.8.1131
129.186.205.791
139.19.158.2351
128.163.142.201
143.215.131.1971
141.212.113.1801
66.140.111.51
129.82.12.1871
141.219.252.1331
131.193.34.381
165.242.90.1291
128.223.8.1121
130.194.252.81
129.107.35.1311
129.22.150.781
128.252.19.191
128.8.126.981
141.161.20.331
203.110.240.1911
203.178.143.101
165.230.49.1151
93.180.0.1141
194.254.215.111
139.19.142.21
142.103.2.11
129.32.84.1611
80.65.237.101
211.69.207.341
139.19.142.61
199.26.254.671
13.7.64.221
156.56.250.2261
128.208.4.1971
140.247.60.1231
128.208.4.1981
219.243.208.621
199.26.254.681
80.65.237.111
129.82.12.1881
138.15.10.561
193.136.124.2261
202.141.161.431
213.131.1.1011
128.8.126.1111
130.73.142.871
147.102.3.1131
202.112.28.1001
128.6.192.1581
131.247.2.2471
128.10.19.531
136.145.115.1961
128.6.192.1561
193.0.109.231
128.112.139.181
142.150.238.131
72.36.112.791
128.36.233.1541
129.74.74.191
131.247.2.2411
155.225.2.711
138.232.66.1741
212.235.189.1151
128.111.52.631
220.245.140.1961
139.30.240.1921
132.170.3.331
193.1.170.1361
194.29.178.51
141.219.252.1321
129.63.159.1011
130.216.1.231
133.9.81.1661
133.9.81.1641
198.82.160.2381
129.97.74.121
219.243.208.601
132.239.17.2241
130.216.1.221
140.123.230.2491
200.17.202.1951
192.42.83.2531
130.253.21.1211
128.42.142.411
138.26.66.51
206.117.37.61
133.15.59.21
128.227.150.121
129.22.150.291
147.229.10.2501
206.23.240.291
128.138.207.541
128.138.207.540
